1
4:4:4:4:4:4:4:4:4:4:4:4:4
4:1:2:2:2:2:2:2:2:2:2:2:4
4:9:3:3:4:3:2:2:2:2:2:2:4
4:9:2:2:4:3:4:2:2:7:2:2:4
4:2:2:2:4:4:4:3:2:2:2:2:4
4:2:2:2:2:2:2:2:2:2:2:2:4
4:2:2:2:2:3:2:2:2:2:2:2:4
4:2:2:2:2:2:2:2:2:2:2:2:4
4:2:3:2:2:2:2:2:2:2:2:2:4
4:2:2:2:2:2:2:3:2:2:10:2:4
4:2:2:2:2:2:2:2:2:2:2:2:4
4:2:2:2:2:2:2:2:2:2:2:2:4
4:4:4:4:4:4:4:4:4:4:4:4:4
