1
4:4:4:4:4:4:4:4:4:4:4:4:4
4:1:9:9:2:2:2:2:2:2:2:2:4
4:2:3:2:2:2:2:2:2:2:2:2:4
4:2:3:2:2:2:2:2:2:2:2:2:4
4:2:4:4:2:2:2:2:2:2:2:2:4
4:2:2:2:2:2:2:2:2:2:2:2:4
4:2:2:2:2:2:2:2:2:2:2:2:4
4:2:2:2:2:2:2:2:2:2:2:2:4
4:2:2:2:2:2:2:2:2:2:2:2:4
4:2:2:2:2:2:2:2:2:2:2:2:4
4:2:2:2:2:2:2:2:2:2:2:2:4
4:2:2:2:2:2:2:2:2:2:2:2:4
4:4:4:4:4:4:4:4:4:4:4:4:4
