1:9:9
4:4:4:4:4:4:4:4:4:4:4:4:4
4:1:2:3:2:2:0:2:2:3:2:8:4
4:2:4:2:4:3:4:2:4:3:4:3:4
4:2:2:0:2:2:3:3:2:2:2:2:4
4:3:4:9:4:3:4:2:4:2:4:3:4
4:2:3:2:2:3:2:2:2:3:2:3:4
4:2:4:3:4:2:4:3:4:0:4:2:4
4:3:2:2:2:2:2:2:3:2:2:2:4
4:2:4:2:4:3:4:2:4:2:4:3:4
4:2:2:0:3:2:3:0:2:3:3:2:4
4:2:4:2:4:2:4:9:4:2:4:2:4
4:3:2:2:2:2:2:3:2:2:2:2:4
4:4:4:4:4:4:4:4:4:4:4:4:4
