2
4:4:4:4:4:4:4:4:4:4:4:4:4
4:1:2:2:3:2:2:3:2:3:2:2:4	
4:2:4:2:4:3:4:2:4:2:4:2:4
4:3:2:0:2:2:3:2:2:0:2:2:4
4:2:4:2:4:2:4:2:4:3:4:2:4
4:2:3:2:3:9:2:2:3:2:2:2:4
4:0:4:3:4:2:4:2:4:3:4:2:4
4:3:3:3:2:2:3:8:2:0:9:2:4
4:2:4:2:4:2:4:3:4:2:4:2:4
4:3:3:2:2:3:0:2:2:3:2:3:4
4:2:4:2:4:3:4:2:4:3:4:2:4
4:8:3:2:3:2:2:2:3:3:2:2:4
4:4:4:4:4:4:4:4:4:4:4:4:4