44444444444
41232222234	
42424242424
43233233224
42424242424
42323322224
43434242424
42232223334
42424243424
48322223224
44444444444