44444444444
41232222234	
42424242424
43203230224
42424242424
42323322224
40434242424
42232220334
42424243424
48322223224
44444444444