4444444444444
4122322322234	
4242434242424
4320923220224
4242424243424
4232332232224
4043424243424
4223223220934
4242424342424
4332230223224
4242424243424
4832332232224
4444444444444