4444444444444
4122322323224	
4242434242424
4320223220224
4242424243424
4232392232224
4043424243424
4333223820924
4242424342424
4332230223234
4242434243424
4832322233224
4444444444444