44444444444
41222222224	
42424242424
42222222224
42424242424
42223322224
42424242424
42222222224
42424242434
48322222324
44444444444