1:2:1:2:1
4:4:4:4:4:4:4:4:4:4:4:4:4
4:1:2:3:3:3:0:3:3:9:3:3:4
4:2:3:3:3:0:3:3:0:3:3:0:4
4:3:0:9:3:3:9:3:3:3:9:3:4
4:4:4:4:4:4:4:4:3:3:3:3:4
4:3:3:3:3:3:3:4:3:9:3:0:4
4:3:3:3:9:3:3:3:3:3:3:3:4
4:3:3:0:3:3:4:3:3:3:3:3:4
4:3:9:3:3:0:4:4:4:4:4:4:4
4:3:3:3:9:3:3:3:3:3:0:3:4
4:3:3:3:3:3:3:0:3:9:3:2:4
4:3:0:9:3:3:9:3:3:3:2:10:4
4:4:4:4:4:4:4:4:4:4:4:4:4
